XXXXXXXXXXXXXXXXXXXXXXXXXXXXXXX
X.**..........................X
X.X.X.X.X.X.X.X.X.X.X.X.X.X.X.X
X...**........................X
X.X.X.X.X.X.X.X.X.X.X.X.X.X.X.X
X.*...........................X
X.X.X.X.X.X.X.X.X.X.X.X.X.X.X.X
X...*.........................X
X.X.X.X.X.X.X.X.X.X.X.X.X.X.X.X
X.............................X
X.X.X.X.X.X.X.X.X.X.X.X.X.X.X.X
X.**..........................X
X.X.X.X.X.X.X.X.X.X.X.X.X.X.X.X
X.............................X
X.X.X.X.X.X.X.X.X.X.X.X.X.X.X.X
X.............................X
X.X.X.X.X.X.X.X.X.X.X.X.X.X.X.X
X.............................X
X.X.X.X.X.X.X.X.X.X.X.X.X.X.X.X
X.............................X
XXXXXXXXXXXXXXXXXXXXXXXXXXXXXXX