###############################
#......**.*....*...*..*.*.*...#
#.#.#.#*#.#.#*#*#.#.#.#*#*#*#.#
#...*.....***..*......*...*.*.#
#.#.#.#.#.#*#.#.#*#*#.#.#.#.#*#
#............**..*..*.........#
#.#.#.#.#.#*#.#.#.#*#.#*#.#.#.#
#*..*......*..*......*........#
#.#.#.#.#*#.#.#.#*#*#.#.#.#.#.#
#*....**..*.......*...........#
#.#*#.#.#.#.#.#.#*#.#.#.#.#.#.#
#...........*...*..*..........#
###############################