#####################
#......**.*....*...*#
#.#.#.#*#.#.#*#*#.#.#
#...*.....***..*....#
#.#.#.#.#.#*#.#.#*#*#
#............**..*..#
#.#.#.#.#.#*#.#.#.#*#
#*..*......*..*.....#
#.#.#.#.#*#.#.#.#*#*#
#*....**..*.......*.#
#####################